최순실	NNP
빅데이터	NNG
노무현재단	NNP
헨리 조지	NNP
알릴레오	NNP
불로소득	NNG
전강수	NNP
경제통상학부	NNP
윤희숙 NNP
국민의힘 NNP
전세난	NNG
연구기관	NNG
주택가격전망지수	NNG
주택산업연구원	NNP
고종완		NNP
한국자산관리연구원장	NNP
빡침	NNG
뉘우스	NNG
우병탁	NNP
양도세	NNG
보유세	NNG
대주택자	NNG
종부세	NNG
자문팀	NNG
등기권리증	NNG
비과세	NNG
묻지마식	NNG
단기투자	NNG
부부공동명의	NNG
단독명의	NNG
매부리	NNP
재배포	NNG
청년층	NNG
게티이미지뱅크	NNP
집들이	NNG
실거주	NNG
분양가	NNG
신정뉴타운	NNG
재개발	NNG
분양가	NNG
아델리체	NNP
업계	NNG
전용면적	NNG
경쟁률	NNG
피트니스센터	NNG
국토교통부	NNP
신시가지	NNG
써밋	NNP
장재현	NNP
리얼투데이	NNP
금융회사	NNG
우상향	NNG
최진석	NNP
DL이앤씨	NNP
e편한세상	NNP
그랑힐스	NNP
모델하우스	NNG
부평나들목	NNP
서인천나들목	NNP
바닥차음재	NNG
방과후 교실	NNG
그린카페	NNG
게스트룸	NNG
특별공급	NNG
더샵퍼스트	NNP
판상형	NNG
산곡북초	NNP
청전중	NNP
인천외국어고	NNP
세일고	NNP
명신여고	NNP
CGV부평	NNP
명신여고	NNP
원적산공원	NNP
뫼골놀이공원	NNP
정연일	NNP
배정철	NNP
미분양	NNG
조정대상	NNG
예비심사	NNG
사전심사	NNG
무단전재	NNG
헤럴드경제	NNP
한국건설산업연구원	NNP
큰 폭	NNG
건산연	NNP
대한건설정책연구원	NNP
KB국민은행	NNP
우리금융연구소	NNP
주산연	NNP
건정연	NNP
매맷값	NNG
지배적	NNG
나홀로	NNG
임대차3법	NNP
매물잠김	NNG
대화기구	NNG
밀리터리	NNG
헤럴드에코	NNP
코로나19	NNP
무권리금	NNG
한국부동산원	NNP
건대입구	NNP
대로	NNG
공공전세	NNG
자치구	NNG
평균면적	NNG
예비입주자	NNG
제조과정	NNG
신림백화점	NNP
현재진행형	NNG
파인트리	NNP
삼정기업	NNP
종교시설	NNG
건설분야	NNG
실태조사	NNG
분석보고서	NNG
불공정	NNG
고용보험	NNP
산업재해	NNP
책임연구원	NNG
개드립	NNP
새끼	NNG
찌질	NNG
졸업사진	NNG
어릴때	NNG
한중	NNP
쉴드	NNG
씨발	NNG
씨푸드	NNG
단종행	NNG
핫칠리	NNG
밤마다	NNG
연상녀	NNG
제로콜라	NNP
칠리파	NNP
성진국	NNP
전술핵	NNP
박테리오	NNP
스타2	NNP
블러핑	NNG
나이브	NNG
상도덕	NNG
사후피임약	NNG
흑토	NNG
해바라기씨	NNP
크루드 오일	NNP
넘사벽	NNG
수율	NNG
햄토리	NNP
최철귀	NNP
해병문학	NNP
전설의 포켓몬	NNG
차량용재떨이	NNG
고독한미식가	NNP
행보관	NNP
샛기덜	NNG
군생활	NNG
종특	NNG
냥이	NNG
옴뇸뇸	NNG
딜도	NNG
육봉이 나르샤	NNP
드론	NNG
시무라	NNP
후드티	NNG
정상수	NNP
츄르	NNP
비추	NNG
단또	NNP
털바퀴	NNP
빌드업	NNG
샛기	NNG
순위권	NNG
더모아	NNG
인버스	NNG
스마게	NNP
선데이토즈	NNP
분할매수	NNP
권혁빈	NNP
로아온	NNP
혁빈	NNP
엔솔	NNP
크래프톤	NNP
개붕이	NNP
매매법	NNG
월	NNG
줍줍	NNG
상한가	NNG
에이피티씨	NNP
추천가	NNG
손절가	NNG
넥스틴	NNP
토목주	NNG
포테이토코인	NNP
풀매수	NNG
담수화 플랜트	NNG
해상도시	NNG
현물	NNG
티큐	NNP
태세전환	NNG
에스티팜	NNP
에코프로	NNP
고려아연	NNP
애플카	NNP
위메이드	NNP
더모아+	NNP
개꿀띠	NNP
스벅	NNP
주식시장	NNG
지지점	NNG
담주	NNG
선전포고	NNG
개고수	NNG
개구리콘	NNP
인싸	NNG
개추	NNP
상폐	NNG
우디르	NNP
레전드 오브 룬테라	NNP
걸그룹	NNG
스압	NNG
로스트아크	NNP
꿀팁	NNG
로아	NNP
스트리머	NNG
왕코	NNP
강소연	NNP
팀킴	NNP
임수지	NNP
가게	NNG
채팅창	NNG
레시피	NNG
격공	NNG
헬창	NNG
쌀케이크	NNG
막짤	NNG
깜장냥이	NNG
햄찌	NNG
서울공화국	NNP
수도이전	NNG
세종시	NNP
성문헌법	NNG
백신패스	NNG
확진자	NNG
거리두기	NNG
RE100	NNP
중증률	NNG
권력자	NNG
악플	NNG
프로미스나인	NNP
해명글	NNG
커뮤	NNG
쿨병	NNG
자가격리	NNG
스엠	NNP
극강	NNG
블랭키	NNP
이영빈	NNP
박시우	NNP
출처	NNG
MZ세대	NNG
NO 차이나	NNP
총체적난국	NNG
일제강점기	NNP
도긴개긴	NNG
개얼탱이	NNG
친중	NNG
세뇌교육	NNG
혐일	NNG
혐중	NNG
인구빨	NNG
홍산 대첩	NNP
진포 대첩	NNP
도토리 키재기	NNG
개노답	NNG
라멘집	NNG
동시접속자	NNG
차민규	NNP
세레머니	NNG
스물다섯	스물하나	NNP
비매너	NNG
도난방지	NNG
역사학계	NNG
탈룰라	NNG
정권교체	NNG
허세왕	NNG
임남규	NNP
인스타	NNG
뻘글	NNG
몬헌	NNG
당근마켓	NNP
디씨인	NNG
한끼	NNG
최애	NNG
간접체험	NNG
권은빈	NNP
군면제	NNG
공포주의	NNG
물속성	NNG
주52시간	NNP
뽀샤시	NNG
사격장	NNG
쫄보	NNG
듣보	NNG
골크	NNP
지지세력	NNG
보복수사	NNG
짬짜미	NNG
퀴어베이팅	NNP
관계성	NNG
페이백	NNG
셀프네일	NNG
미러파우더	NNG
모럴센스	NNP
동접	NNG
한국겜	NNP
최애캐	NNG
도장깨기	NNG
이모지	NNG
뇌속	NNG
카카오페이	NNP
발연기	NNG
위버스샵	NNP
자가키트	NNG
한율	NNP
달빛유자	NNG
시트마스크	NNG
s22u	NNP
중형	NNG
백짬뽕	NNP
S22	NNP
스타필드	NNP
s22	NNP
무속정치	NNG
좌빠	NNG
검찰총장	NNG
디파이2	NNP
유류세	NNG
요기요	NNP
관용매체	NNG
착짱죽짱	NNP
짱개	NNP
가족단	NNG
sd카드	NNG
삼성페이	NNP
디지털성범죄	NNG
대깨윤	NNP
Z플립	NNP
S21	NNP
노트20U	NNP
카톡	NNP
버즈2	NNP
체감가	NNG
알바비	NNG
버럭스쿨	NNP
조코피디	NNP
S20	NNP
공기질	NNG
가짜뉴스	NNG
패드립	NNG
kb비즈	NNP
무실적	NNG
대형마트	NNG
단일화	NNG
비과학적	NNG
탭S8+	NNP
사전예약	NNG
구매처	NNG
셀프디스	NNG
대선후보	NNG
확률업	NNG
키우기	NNG
파판12	NNP
구태정치	NNG
크로스파이어X	NNP
에테	NNP
렘룬	NNP
블루아카	NNP
재믹스슈퍼	NNP
밀렵단	NNG
히스이	NNP
뻘짓거리	NNG
용의 꼬리	NNG
소신발언	NNG
세구빛	NNP
무발기사정	NNG
디지몬	NNG
털박이	NNG
여성형	NNG
엔젤우몬	NNP
라오진	NNP
짤류	NNG
충북도당	NNP
J-POP	NNG
모음글	NNG
국힘	NNP
국가부채	NNG
국짐	NNP
캐릭	NNG
쓰레셔	NNP
메스가키	NNP
유게이	NNP
백탁액	NNG
모바일겜	NNG
파칭코	NNG
노이해	NNG
피쳐폰	NNG
프리코네	NNP
자캐	NNG
법조계	NNG
꿀빵	NNG
Frank Sinatra	NNP
고유정	NNP
실명제	NNG
논리왕전기	NNP
펨코	NNP
국힘당	NNP
채서은	NNP
지우학	NNP
술한잔	NNG
조이현	NNP
그림자놀이	NNG
물한방울	NNG
대학대전	NNG
염석대	NNG
남덕선	NNP
오픈빨	NNG
일찐	NNG
간짜장	NNG
스타대학	NNP
지존쇼	NNP
개좆두	NNP
암탄소년단	NNP
가스라이팅	NNG
바이오닉	NNG
개병신	NNG
이백조	NNP
전프로	NNG
와고인	NNP
여캠	NNG
개씨발	NNG
품번	NNG
손스타	NNG
남순	NNP
묻사건	NNP
약속왕	NNG
찐	NNG
몽군	NNG
자산세	NNG
근로소득세	NNG
전쟁광	NNG
좋은날	NNP
건진법사	NNP
갭투자	NNG
매매가	NNG
신속항원	NNG
파르미지아노레지아노	NNP
파르미지아노 레지아노	NNP
뇌인지	NNG
에릭켄달	NNP
하트시그널	NNP
하트시그널2	NNP
언로중재법	NNP
다카끼마사오	NNP
허위기사	NNG
내로남불	NNG
폭망	NNG
렌트프리	NNG
정치꾼	NNG
새정치	NNG
부모님	NNG
골프백	NNG
간장게장	NNG
고사양	NNG
욕도배	NNG
맛집	NNG
까페투어	NNG
베이징올림픽	NNG
심리상담사	NNG
재가센터	NNG
요양센터	NNG
요양사	NNG
적폐세력	NNG
반통일	NNG
반민주	NNG
고인물	NNG
홈트	NNG
완료자	NNG
윗님	NNG
잔여백신	NNG
빼박	NNG
두세번	NNG
바디로션	NNG
핸드크림	NNG
풋크림	NNG
화천대유	NNP
위례자산관리	NNP
등기이사	NNG
남욱	NNP
나혼자 산다	NNP
T자	NNG
물리치료사	NNG
허리 디스크	NNG
핸드워시	NNG
군것질거리	NNG
올리브오일	NNG
아보카도오일	NNG
샤인머스켓	NNG
이죄명	NNP
무속인	NNP
전과4범	NNG
지지단체	NNG
여론조사	NNG
이용가치	NNG
드립	NNG
세상물정	NNG
경쟁업체	NNG
경기지사	NNG
518	NNP
민주세력	NNG
법무부장관	NNG
도덕점수	NNG
압색	NNG
기획수사	NNG
드루킹	NNP
통정거래	NNG
부당이익	NNG
기획재정부	NNG
장기여행	NNG
다달이	NNG
조국 사태	NNP
유력후보	NNG
이대남	NNG
최강욱	NNP
식스센스	NNP
윤파	NNP
방사통	NNG
근육주사	NNG
스포츠마사지	NNG
거북목	NNG
도수치료	NNG
통증의학과	NNG
목디스크	NNG
플립3	NNP
근첩	NNP
화강돌	NNG
겟또	NNG
댕댕이	NNG
유튜버	NNG
서울시장	NNG
입마개	NNG
주급	NNG
할인행사	NNG
버튜버	NNG
로나땅	NNP
떼껄룩	NNG
윤빠	NNG
블랙기업	NNG
짜왕	NNG
거유녀	NNG
관함식	NNG
빅찌찌	NNG
웃대인	NNG
페이트	NNG
보험사기	NNG
호텔델루나	NNP
연느	NNP
ㅇㅎ	NNG
무장강도	NNG
기상청 사람들	NNP
시사타파	NNP
힘순찐	NNG
눈나	NNG
중립기어	NNG
염보	NNP
꿀비	NNP
다임이	NNP
무친대	NNP
구성표	NNG
남친	NNG
존잘남	NNG
전자녀	NNG
전닉	NNG
가스라이팅	NNG
쌤통	NNG
기뉴다	NNP
감스트	NNP
키스신	NNG
꼴까닥	NNG
순자산	NNG
추심단	NNG
언플	NNG
서해5도	NNP
멀미	NNG
오십대	NNG
갭투	NNG
월세	NNG
전세가	NNG
아크로비스타	NNP
르두	NNP
재발견	NNG
하체	NNG
머리결	NNG
사랑의 불시착	NNP
맨트	NNG
시크릿가든	NNP
조혜련	NNP
접촉자	NNG
근막염	NNG
일베	NNP
첫댓글	NNG
전과	NNG
집단지성	NNG
좌훈기	NNG
반사회	NNG
보상심리	NNG
신박	NNG
팩폭	NNG
R&D	NNG
엘시티	NNP
윤우진	NNP
코바나콘텐츠	NNP
검언	NNP
도이치파이낸셜	NNP
한림성심대	NNP
컴퓨터응용과	NNG
서일대	NNP
수원여대	NNP
영락여고	NNP
세기의 커플	NNG
시크릿가든	NNP
최전성기	NNG
스타트업	NNG
정치극	NNG
자가진단	NNG
킹크랩	NNG
댓글부대	NNG
차차기	NNG
삼프로	NNP
비호감	NNG
찐천재	NNG
연설장	NNG
하네마네	NNG
악마화	NNG
헛수고	NNG
초미니	NNG
낙서질	NNG
탑스타	NNG
여자bj	NNG
성상품화	NNG
샤워씬	NNG
팬서비스	NNG
조폭	NNG
사유화	NNG
이명박근혜	NNP
스킬	NNG
컴린이	NNG
눈밑	NNG
맘카페	NNG
지박령	NNG
자게	NNG
손절	NNG
사원증	NNG
오배송	NNG
백만원	NNG
횡단보도	NNG
리터	NNG
멍뭉이	NNG
무단주차	NNG
블루링크	NNP
맛탱이	NNG
인생의낙	NNG
삶의질	NNG
아랫글	NNG
초등생	NNG
우한폐렴	NNP
오미크론	NNP
섬유화	NNG
시시티비	NNG
짱퀴벌레	NNG
외연도	NNP
썬루프	NNG
삼겹	NNG
화로	NNG
AB형	NNG
수혈자	NNG
서울성모병원	NNP
A-PLT	NNG
혈액관리본부	NNP
20대	NNG
짱께국	NNP
젖깔	NNG
아이너리	NNG
개물림	NNG
2D	NNG
뻑가	NNP
자기계발	NNG
신박한	VA
순둥순둥	NNG
케이3	NNP
페미	NNG
엑츄레이터	NNG
남탓	NNG
플래시몹	NNG
1절	NNG
크림반도	NNG
소비에트연합	NNP
친러	NNG
정치글	NNG
수입차	NNG
견적	NNG
전소미	NNP
반헌법	NNG
브이앱	NNP
대참사	NNG
오미크론	NNP
s10	NNP
인별	NNP
락킷걸	NNP
한이슬	NNP
움짤	NNG
짤방	NNG
역주행	NNG
투머치토크	NNG
키즈폰	NNG
성소수자	NNG스타레일	NNP
인세인	NNP
뉴게임	NNP
휴가비	NNP
개껌	NNP
LK-99	NNP
초전도	NNP
젖탱이	NNP
미트스핀	NNP
오버핏	NNP
연차	NNP
깡딜	NNP
즉사	NNP
가챠	NNP
느와르	NNP
념글	NNP
근황	NNP
이용자	NNP
색감	NNP
장어덮밥	NNP
최원태	NNP
탁송기사	NNP
드리프트	NNP
